..................................................
..................................................
..................................................
..................................................
..................................................
..................................................
..................................................
..................................................
......########......##....#############...........
......##............##..........##................
......##............##..........##................
......##............##..........##................
......##............##..........##................
......##............##..........##................
......########......##..........##................
......##............##..........##................
......##............##..........##................
......##............##..........##................
......##............##..........##................
......##............##..........##................
......##............##..........##................
......##............##..........##................
..................................................
..................................................
..................................................
..................................................
..................................................
..................................................
..................................................
..................................................