#..........#############################..........#
#......................................#..........#
#......................................#..........#
#......................................#..........#
#.................................................#
#.................................................#
##################................................#
#.................................................#
#.................................................#
#.................................................#
#......................................#..........#
#......................................#..........#
#......................................#..........#
#.........##############################..........#
#......................................#..........#
#......................................#..........#
#......................................#..........#
#......................................#..........#
#......................................#..........#
#......................................#..........#
#.................................................#
#########################.........................#
#.................................................#
#.................................................#
#.................................................#
#.................................................#
#......................................#..........#
#......................................#..........#
#......................................#..........#
#..........#############################..........#